###############################
# ............................#
#                             #
#     ############.#          #
#     #...#......#.#          #
#     #.#........#.#          #
#     #.##########.#          #
#                             #
#                             #
###############################