############################
#............##............#
#.####.#####.##.#####.####.#
#..........................#
#.####.##.########.##.####.#
#......##....##....##......#
##  ##.#####.##.#####.######
##  ##.##..........##.######
##  ##.##.###  ###.##.######
##  ##.##.#      #.##.######
#.........#      #.........#
######.##.#      #.##.##  ##
######.##.########.##.##  ##
#......##..........##...  ##
#.####.##.########.##.##  ##
#............##............#
#.####.#####.##.#####.####.#
#...##................##...#
###.##.##.########.##.##.###
#......##....##....##......#
#.##########.##.##########.#
#..........................#
#.####.#####.##.#####.####.#
#............##............#
############################
